111111111111111111
111111111111111111
111000000000000011
111000000000000011
111000000000000011
111111111111111111
111111111111111111