	
	y
x	1111111111111111111111111111111
	100C000000000000000000000000001
	10000000000000000000000C0000001
	100000000E000000000000000000001
100000000000000000000000C000001
1000000000000000000000000000001
1000000000000000000000000000001
1000C00000000000000000000000001
1000000000000000000000000000E01
1000000000000000000P00000000001
1000000000000000000000000000001
1000000000C00000000000000000001
1111111111111111111111111111111