1111111111111111111111111111111111
1E000000000010C010000000A000A00001
1010C10100100A001010010000C0010101
101A010010101010001001000100010101
100000C000000000A00A00001000100001
100101010101010101000100000000A001
100000000010C01010000000C0000010C1
1000000000010000100100000010000A01
10A00C0000001000A0000A000100000001
1000000000A00000000000000100000001
100000A001001000000001010000100111
1P10011000000000100010C001000000E1
1111111111111111111111111111111111