1111111111111111111111111111111111
10000000A00000C0100000000000000001
1010C10100100000101001000000010101
1010010010101010001001000100010101
100000C01E100000000000001000000001
10010100000010101010001C000000A001
100000000010010010000000C000010001
10000000000101P0100C00000010000001
1000A00000000000000000000100000001
1111111111111111111011111111111111
10000100010010000000000100001000E1
101000C00000000000A000000100000001
1111111111111111111111111111111111