1111111111111111111111111111111111
10000000000000C0100000000000000001
1010C10100100000101001000000010101
1010010011101010001001000100010101
100000C01E100000000000001000000001
1001010111110101010001C00000000001
100000000010010010000000C000010001
10000000000101P0100C00000010000001
1000000000001111100000000100000001
1111111111111111111011111111111111
10000100010010000000010100001010E1
101000C000000000100000000100000001
1111111111111111111111111111111111